..x########.....
..x########.....
####xB...x#.....
####x....x#.....
##...P...x#.....
##...P...x#.....
##.......x######
##.......x######
##...P.##.....##
##...P.##.....##
##............##
##............##
####x....x######
####x....x######
..x########.....
..x########.....
